{
	"name":"main",
	"tile_size":100,
	"objects":[
		["G","G","G","G","G","G","G","G","G","G","G","G"],
		["G","G","G","G","G","G","G","P","G","G","G","G"],
		["G","B","G","G","G","G","G","G","P","G","G","G"],
		["G","G","G","G","G","G","G","G","G","G","G","G"],
		["G","G","P","P","G","G","G","G","G","G","G","G"],
		["G","G","G","G","G","G","G","G","G","G","G","G"],
		["G","G","G","G","G","G","G","G","G","G","G","G"]
	]
}